There has been a murder in the mansion on Royal boulevard. You are one of Hawaii's most famous detectives. Find out who killed Rich, the mansion owner. This case, if solved, could get you the promotion to chief.

You find your way to the Boat to begin the search.

FINAL PROJ
An Interactive Fiction by Jordan Tome
Release 1 / Serial number 131009 / Inform 7 build 6G60 (I6/v6.32 lib 6/12N) SD

Boat
a magnificant yacht called the USS Shayna in honor of Mr. Rich's late wife. There is a fire extinguisher and a flare gun as well.

You can see a fire extinguisher and a flashlight here.

I beg your pardon?

I beg your pardon?

* * *

There has been a murder in the mansion on Royal boulevard. You are one of Hawaii's most famous detectives. Find out who killed Rich, the mansion owner. This case, if solved, could get you the promotion to chief.

You find your way to the Boat to begin the search.

FINAL PROJ
An Interactive Fiction by Jordan Tome
Release 1 / Serial number 131009 / Inform 7 build 6G60 (I6/v6.32 lib 6/12N) SD

Boat
a magnificant yacht called the USS Shayna in honor of Mr. Rich's late wife. There is a fire extinguisher and a flare gun as well.

You can see a fire extinguisher and a flashlight here.

>inside
conservatory
greenhouse with plants and a broken telescope. Something about the telescope might help you.

You can see a telescope (in which are a screw key, a finderscope and a base) here.

>take telescope
Taken.

>i
You are carrying:
  a telescope
    a finderscope
    a screw
    a base

>combine finderscope with base
(first taking the finderscope)
(first taking the base)

>combine
(the finderscope with the base)

>yes
That was a rhetorical question.

>scope base
(the base)
1: yourself (41)
2: a base (48)
3: a finderscope (46)
4: a telescope (45)
5: a screw (47)

>x scope base
You can't see any such thing.

* * *

>i
You are carrying:
  a telescope
    a finderscope
    a screw
    a base

>x fingerscope
You can't see any such thing.

* * *

>inside
conservatory
greenhouse with plants and a broken telescope. Something about the telescope might help you.

You can see a telescope (in which are a screw key, a finderscope and a base) here.

>e
living room
a place where the family came to eat. There is a dining table, a vase with flowers, and a butler named bob.

>x bob
Bob is the butler of Mr. Rich's mansion. He is here everyday and helps out in any way that he can.

>talk to bob
Hello Officer, I may be able to assist you. Before Mr. Rich got murdered, he gave me a box and said to never let this out of sight, but I could never find the key for it. So, if you can find the key, we can open it and see what is inside. The only clue he gave me was that the key is somewhere up high.

* * *

>e
living room
a place where the family came to eat. There is a dining table, a vase with flowers, and a butler named bob.

>e
kitchen
a place for cooking with a knife, TV, and a spatula.

You can see a gold door here.

>e
(first opening the gold door)
It seems to be locked.

>take door
That's fixed in place.

>go inside
You can't go that way.

>enter bedroom
You can't see any such thing.

>open door
You open the gold door.

>close door
You close the gold door.

>take bed
You can't see any such thing.

* * *

>e
(first opening the gold door)
It seems to be locked.

>take bed
Taken.

* * *

>inside
conservatory
greenhouse with plants and a broken telescope. Something about the telescope might help you.

You can see a telescope (in which are a screw key, a finderscope and a base) here.

>w
You can't go that way.

>e
living room
a place where the family came to eat. There is a dining table, a vase with flowers, and a butler named bob.

>w
conservatory
greenhouse with plants and a broken telescope. Something about the telescope might help you.

You can see a telescope (in which are a screw key, a finderscope and a base) here.

>e
living room
a place where the family came to eat. There is a dining table, a vase with flowers, and a butler named bob.

>e
kitchen
a place for cooking with a knife, TV, and a spatula.

>e
Bedroom
a place for sleeping. There is a bed, a clock, drawer, and a safe.

You can see a gold door here.

>take bed
You can't see any such thing.

>take clock
You can't see any such thing.

>take drawer
You can't see any such thing.

>x safe
You can't see any such thing.

>x drawer
You can't see any such thing.

>x door
You see nothing special about the gold door.

* * *

There has been a murder in the mansion on Royal boulevard. You are one of Hawaii's most famous detectives. Find out who killed Rich, the mansion owner. This case, if solved, could get you the promotion to chief.

You find your way to the Boat to begin the search.

FINAL PROJ
An Interactive Fiction by Jordan Tome
Release 1 / Serial number 131009 / Inform 7 build 6G60 (I6/v6.32 lib 6/12N) SD

Boat
a magnificant yacht called the USS Shayna in honor of Mr. Rich's late wife. There is a fire extinguisher and a flare gun as well.

You can see a fire extinguisher and a flashlight here.

>e
You can't go that way.

* * *

>w
You can't go that way.

>go inside
conservatory

>w
living room

* * *

There has been a murder in the mansion on Royal boulevard. You are one of Hawaii's most famous detectives. Find out who killed Rich, the mansion owner. This case, if solved, could get you the promotion to chief.

You find your way to the Boat to begin the search.

FINAL PROJ
An Interactive Fiction by Jordan Tome
Release 1 / Serial number 131009 / Inform 7 build 6G60 (I6/v6.32 lib 6/12N) SD

Boat
a magnificant yacht called the USS Shayna in honor of Mr. Rich's late wife. There is a fire extinguisher and a flare gun as well.

You can see a fire extinguisher and a flashlight here.

>go inside
conservatory
You can see a telescope (in which are a finderscope, a screw and a base) here.

>w
You can't go that way.

>n
Bathroom

>n
You can't go that way.

>up
Attic

* * *

>w
You can't go that way.

>e
living room

>n
Bathroom

>up
Darkness
It is pitch dark, and you can't see a thing.

>restart
Are you sure you want to restart?

* * *

>go inside
conservatory
You can see a telescope (in which are a finderscope, a screw and a base) here.

>n
You can't go that way.

>e
You can't go that way.

>w
living room

* * *

>go inside
conservatory
You can see a telescope (in which are a finderscope, a screw and a base) here.

>enter
You must supply a noun.

>enter conservatory
You can't see any such thing.

>undo
conservatory
[Previous turn undone.]

* * *

There has been a murder in the mansion on Royal boulevard. You are one of Hawaii's most famous detectives. Find out who killed Rich, the mansion owner. This case, if solved, could get you the promotion to chief.

You find your way to the Boat to begin the search.

FINAL PROJ
An Interactive Fiction by Jordan Tome
Release 1 / Serial number 131009 / Inform 7 build 6G60 (I6/v6.32 lib 6/12N) SD

Boat
a magnificant yacht called the USS Shayna in honor of Mr. Rich's late wife. There is a fire extinguisher and a flare gun as well.

You can see a fire extinguisher and a flashlight here.

>w
You can't go that way.

* * *

>e
You can't go that way.

>go inside
conservatory

>e
You can't go that way.

* * *

>w
living room

>s
Man cave

>down
Garage

* * *

>w
You can't go that way.

>inside
conservatory
You can see a telescope (empty) here.

>take telescope
Taken.

* * *

>turn on telescope
That's not something you can switch.

* * *

There has been a murder in the mansion on Royal boulevard. You are one of Hawaii's most famous detectives. Find out who killed Rich, the mansion owner. This case, if solved, could get you the promotion to chief.

You find your way to the Boat to begin the search.

FINAL PROJ
An Interactive Fiction by Jordan Tome
Release 1 / Serial number 131009 / Inform 7 build 6G60 (I6/v6.32 lib 6/12N) SD

Boat
a magnificant yacht called the USS Shayna in honor of Mr. Rich's late wife. There is a fire extinguisher and a flare gun as well.

You can see a fire extinguisher and a flashlight here.

>take flashlight
Taken.

* * *

>up
Darkness
It is pitch dark, and you can't see a thing.

>turn on
(the flashlight)
Yay! you can finally see something in this dark dark room.

Attic
Many paintings, books, and treasure which belongs to the Rich family.

>undo
Darkness
[Previous turn undone.]

>x flashlight
It is pitch dark, and you can't see a thing.

* * *

>inside
conservatory
greenhouse with plants and a broken telescope. Something about the telescope might help you.

You can see a telescope (in which are a screw key, a finderscope and a base) here.

>n
You can't go that way.

* * *

>w
conservatory
greenhouse with plants and a broken telescope. Something about the telescope might help you.

You can see a telescope (in which are a screw key, a finderscope and a base) here.

>w
You can't go that way.

* * *

>e
living room
a place where the family came to eat. There is a dining table, a vase with flowers, and a butler named bob.

>n
Bathroom
a place to do your business. There is a toothbrush and a toilet.

You can see a toothbrush here.

>up
Darkness
It is pitch dark, and you can't see a thing.

>turn on flashlight
Yay! you can finally see something in this dark dark room.

Attic
Many paintings and books.

You can see a paintings and a books here.

>x paintings
You see nothing special about the paintings.

>take paintings
a gold key appears from underneath the paintings.

>take key
Taken.

>i
You are carrying:
  a gold key
  a paintings
  a flashlight (providing light)

>w
You can't go that way.

>down
Bathroom
a place to do your business. There is a toothbrush and a toilet.

You can see a toothbrush here.

>w
You can't go that way.

>s
living room
a place where the family came to eat. There is a dining table, a vase with flowers, and a butler named bob.

>e
kitchen
a place for cooking with a knife, TV, and a spatula.

You can see a gold door here.

* * *

>e
(first opening the gold door)
It seems to be locked.

>unlock door
What do you want to unlock the gold door with?

>key
You unlock the gold door.

>open door
You open the gold door.

>e
Bedroom
a place for sleeping. There is a bed, a clock, drawer, and a safe.

You can see a gold door and a door here.

* * *

>take flashlight
Taken.

>go inside
conservatory

I beg your pardon?

>n
You can't go that way.

>w
living room

>n
Bathroom

* * *

>n
You can't go that way.

>up
Darkness
It is pitch dark, and you can't see a thing.

>use flashlight
That's not a verb I recognise.

>turn on flashlight
Yay! you can finally see something in this dark dark room.

Attic
a room where the light swtich doesnt work, you may need some sort of lighting device.

* * *

>take flashlight
Taken.

>turn on flashlight
You switch the flashlight on.