There has been a murder in the mansion on Royal boulevard. You are one of Hawaii's most famous detectives. Find out the murder weapon that killed Rich, the mansion owner. This case, if solved, could get you the promotion to  assistant chief. You are successful once you can get the chief the weapon.

You find your way to the Boat to begin the search.

Who Did It?
An Interactive Fiction by Jordan Tome
Release 1 / Serial number 131018 / Inform 7 build 6G60 (I6/v6.32 lib 6/12N) SD

Boat
a magnificant yacht called the USS Shayna in honor of Mr. Rich's late wife. There is a fire extinguisher and a flare gun. There may be more clues inside the house.

You can see a fire extinguisher, a flare gun and a flashlight here.

>flashlight
That's not a verb I recognise.

>take flashlight
Taken.

>inside
conservatory
greenhouse with plants and a broken telescope. Something about the telescope might help you.

You can see a telescope (in which are a screw key, a finderscope and a base) here.

>take screw key
Taken.

>e
living room
a place where the family came to eat. There is a dining table, a vase, and a butler named bob.

You can see a pool door here.

>s
Man cave
there is a bar, couches, pool table, 100" tv, and Wilfred, Mr. Rich's best friend and a pool stick. There is a room underneath you as well.

You can see a bar, a couches, a pool table, a pool stick and a 100' tv here.

>take pool stick
Taken.

>n
living room
a place where the family came to eat. There is a dining table, a vase, and a butler named bob.

You can see a pool door here.

>unlock pool door with pool stick
You unlock the pool door.

>open pool door
[Your score has just gone up by one point.]

>e
kitchen
a place for cooking with a knife, and a TV.

You can see a pool door, a gold door, a knife and a tv here.

>undo
living room
[Previous turn undone.]

>open pool door
That's already open.

>undo
living room
[Previous turn undone.]

* * *

>open pool door
That's already open.

>w
conservatory
greenhouse with plants and a broken telescope. Something about the telescope might help you.

You can see a telescope (in which are a finderscope and a base) here.

>e
living room
a place where the family came to eat. There is a dining table, a vase, and a butler named bob.

You can see a pool door here.

>open pool door
That's already open.

>e
kitchen
a place for cooking with a knife, and a TV.

You can see a pool door, a gold door, a knife and a tv here.

>unlock gold door
What do you want to unlock the gold door with?

>with screw key
You can't see any such thing.

>unlock gold door with gold key
I only understood you as far as wanting to unlock the gold door with the gold door.

>w
living room
a place where the family came to eat. There is a dining table, a vase, and a butler named bob.

You can see a pool door here.

>w
conservatory
greenhouse with plants and a broken telescope. Something about the telescope might help you.

You can see a telescope (in which are a finderscope and a base) here.

* * *

>e
living room
a place where the family came to eat. There is a dining table, a vase, and a butler named bob.

You can see a pool door here.

>n
Bathroom
a place to do your business. There is a toothbrush and a toilet. It looks like there might be a room above you as well.

You can see a toothbrush here.

>up
Darkness
It is pitch dark, and you can't see a thing.

>turn on flashlight
Yay! you can finally see something in this dark dark room.

Attic
 A room full of memories such as paintings and books. This was Mr. Rich's secret room that not many people knew about because it was above the bathroom.

You can see a paintings and a books here.

>take paintings
a gold key appears from underneath the paintings.

>take key
(the gold key)
Taken.

>down
Bathroom
a place to do your business. There is a toothbrush and a toilet. It looks like there might be a room above you as well.

You can see a toothbrush here.

>s
living room
a place where the family came to eat. There is a dining table, a vase, and a butler named bob.

You can see a pool door here.

>e
kitchen
a place for cooking with a knife, and a TV.

You can see a pool door, a gold door, a knife and a tv here.

>e
(first opening the gold door)
It seems to be locked.

>unlock pool door
What do you want to unlock the pool door with?

>pool stick
That's unlocked at the moment.

>open pool door
That's already open.

>e
(first opening the gold door)
It seems to be locked.

>e
(first opening the gold door)
It seems to be locked.

>unlock gold door
What do you want to unlock the gold door with?

>gold key
You unlock the gold door.

>e
(first opening the gold door)
Bedroom
a place for sleeping. There is a bed, a clock, and a safe.

You can see a gold door, a door, a bed, a clock and a safe (closed) here.

you are in the bedroom.

Bedroom
a place for sleeping. There is a bed, a clock, and a safe.

You can see a gold door, a door, a bed, a clock and a safe (closed) here.

>unlock safe
What do you want to unlock the safe with?

>screw key
Which do you mean, the gold key or the screw key?

>unlock safe with screw key
You unlock the safe.

>open safe
there is a piece of broken glass in here.

>take broken glass
[Your score has just gone up by one point.]

* * *

>take all
fire extinguisher: Taken.
flare gun: Taken.
flashlight: Taken.

>w
You can't go that way.

>e
You can't go that way.

>s
You can't go that way.

>n
You can't go that way.

>north
You can't go that way.

>west
You can't go that way.

>south
You can't go that way.

>east
You can't go that way.

>go inside
conservatory
greenhouse with plants and a broken telescope. Something about the telescope might help you. You can go N,S,E,W

You can see a telescope (in which are a screw key, a finderscope and a base) here.

>inventory
You are carrying:
  a flashlight
  a flare gun
  a fire extinguisher

>x telescope
a telescope that has been smashed, but some parts are still intact, may be used for something else.

In the telescope are a screw key, a finderscope and a base.

[Your score has just gone up by one point.]

>take all
telescope: Taken.
screw key: Taken.
finderscope: Taken.
base: Taken.

>n
You can't go that way.

* * *

>north
You can't go that way.

>east
living room
a place where the family came to eat. There is a dining table, a vase with flowers, and a butler named bob.

>x bob
Bob is the butler of Mr. Rich's mansion. He is here everyday and helps out in any way that he can.

>x vase with flowers
I only understood you as far as wanting to examine the vase.

>x table
a long table that has nice furnishings. Not many things on this table.

>talk to bob
Hello Officer, I may be able to assist you. Before Mr. Rich got murdered, he gave me a box and said to never let this out of sight, but I could never find the key for it. So, if you can find the key, we can open it and see what is inside. The only clue he gave me was that the key is somewhere up high.

>take key
You already have that.

>south
Man cave
there is a bar, couches, pool table, 100" tv, and Wilfred, Mr. Rich's best friend. There is a room underneath you as well.

You can see a 100' tv here.

>x tv
a huge tv made for watching movies and football.

>s Willfred
I only understood you as far as wanting to s the vase.

>x willfred
You can't see any such thing.

>x Wilfred
Wilfred is Mr. Rich's best friend. He use to be homeless, but Mr. Rich decided to let him sleep and live in the Man cave. He is very sloppy, but respects Mr. Rich very much and does whatever he can to help around.

>talk to Wilfred
Sup Officer, I didn't do anything. I've been in this Man Cave ever since I got here and I am also Mr. Rich's best friend. There is no way I would have committed a murder. Please tell me who killed my best friend when you find out. Thank you.

>talk to Mr. Rich's best friend
You can't see any such thing.

>x tv
a huge tv made for watching movies and football.

>take tv
Taken.

>x bar
a place where specialty drinks and maitai's are made.

>x couches
very comfortable as if sitting on a cloud.

>x pool table
a fun game where you have to shoot the balls into the pockets.

>south
You can't go that way.

>north
living room
a place where the family came to eat. There is a dining table, a vase with flowers, and a butler named bob.

>south
Man cave
there is a bar, couches, pool table, 100" tv, and Wilfred, Mr. Rich's best friend. There is a room underneath you as well.

>west
You can't go that way.

>east
You can't go that way.

>north
living room
a place where the family came to eat. There is a dining table, a vase with flowers, and a butler named bob.

>north
Bathroom
a place to do your business. There is a toothbrush and a toilet. It looks like there might be a room above you as well.

You can see a toothbrush here.

>k toothbrush
That's not a verb I recognise.

>k toilet
That's not a verb I recognise.

>x toothbrush
a device to clean your teeth.

>x toilet
a porcelain seat with water inside. It is clogged and unusable.

>take all
toothbrush: Taken.

>north
You can't go that way.

>go up
Darkness
It is pitch dark, and you can't see a thing.

>use flashlight
[Your score has just gone up by one point.]

>north
You can't go that way.

>south
You can't go that way.

>north
You can't go that way.

>go down
Bathroom
a place to do your business. There is a toothbrush and a toilet. It looks like there might be a room above you as well.

>go up
Darkness
It is pitch dark, and you can't see a thing.

* * *

>use flashlight
[Your score has just gone up by one point.]

>look around
You can't see any such thing.

>x darkness
You can't see any such thing.

>x room
You can't see any such thing.

>turn on flashlight
Yay! you can finally see something in this dark dark room.

Attic
Many paintings and books.

You can see a paintings and a books here.

>x paintings
Artwork from Mr. Rich's childhood days. You may want to take them and give it to the family.

>x books
A lot of big fantasy reading books, but also a lot of politics and money management.

>s
You can't go that way.

* * *

>n
You can't go that way.

>w
You can't go that way.

* * *

>e
You can't go that way.

>go up;
You can't see any such thing.

>go up
You can't go that way.

>go left
You can't see any such thing.

>go right
You can't see any such thing.

>go down
Bathroom
a place to do your business. There is a toothbrush and a toilet. It looks like there might be a room above you as well.

>go up
Attic
Many paintings and books.

You can see a paintings and a books here.

>take all
paintings: a gold key appears from underneath the paintings.
books: Taken.

>take gold key
Taken.

>go down
Bathroom
a place to do your business. There is a toothbrush and a toilet. It looks like there might be a room above you as well.

>x toilet
a porcelain seat with water inside. It is clogged and unusable.

>south
living room
a place where the family came to eat. There is a dining table, a vase with flowers, and a butler named bob.

>inventory
You are carrying:
  a gold key
  a books
  a paintings
  a toothbrush
  a 100' tv
  a base
  a finderscope
  a screw key
  a telescope
  a flashlight (providing light)
  a flare gun
  a fire extinguisher

* * *

>x table
a long table that has nice furnishings. Not many things on this table.

>south
Man cave
there is a bar, couches, pool table, 100" tv, and Wilfred, Mr. Rich's best friend. There is a room underneath you as well.

* * *

>x bar
a place where specialty drinks and maitai's are made.

>go down
Garage
There is a car, a workbench, and many tools.

You can see a car, a workbench and a tools here.

>x workbench
There are many different tools on this workbench.

>take tools
Taken.

>x car
a silky smooth black bentley, but it seems to be locked.

>take car?
You can't see any such thing.

>take car
Taken.

>unlock car
What do you want to unlock the car with?

>inventory
You are carrying:
  a car
  a tools
  a gold key
  a books
  a paintings
  a toothbrush
  a 100' tv
  a base
  a finderscope
  a screw key
  a telescope
  a flashlight (providing light)
  a flare gun
  a fire extinguisher

>unlock car
What do you want to unlock the car with?

>gold key
That doesn't seem to be something you can unlock.

>unlock car
What do you want to unlock the car with?

>screw key
Which do you mean, the gold key or the screw key?

>x car
a silky smooth black bentley, but it seems to be locked.

>open car
That's not something you can open.

>unlock ca
You can't see any such thing.

* * *

>inside
conservatory
greenhouse with plants and a broken telescope. Something about the telescope might help you.

You can see a telescope (in which are a screw key, a finderscope and a base) here.

>take telescope
That's fixed in place.

>take screw key
Taken.

* * *

>inside
conservatory
greenhouse with plants and a broken telescope. Something about the telescope might help you.

You can see a telescope (in which are a screw key, a finderscope and a base) here.

>e
living room
a place where the family came to eat. There is a dining table, a vase, and a butler named bob.

>e
kitchen
a place for cooking with a knife, and a TV.

You can see a gold door, a knife and a tv here.

>e
(first opening the gold door)
It seems to be locked.

>n
You can't go that way.

>w
living room
a place where the family came to eat. There is a dining table, a vase, and a butler named bob.

>n
Bathroom
a place to do your business. There is a toothbrush and a toilet. It looks like there might be a room above you as well.

You can see a toothbrush here.

* * *

I beg your pardon?

* * *

>e
kitchen
a place for cooking with a knife, and a TV.

You can see a gold door, a knife and a tv here.

>take tv
Taken.

>take TV
You already have that.

* * *

>take screw key
Taken.

>x screw key
you combined the Scope Base with the screw to get screw key.

[Your score has just gone up by one point.]

* * *

>x extuinguisher
You can't see any such thing.

>x extinguisher
a red tank that suppresses fires.

>take extinguisher
Taken.

>x flare gun
a gun shaped item used in case of emergency.

>take gun
Taken.

>i
You are carrying:
  a flare gun
  a fire extinguisher

>x me
A highly respected police officer with the highest honors.

>take all
You don't have enough hands to take all these items at once.

>go n
You can't go that way.

>go s
You can't go that way.

>go e
You can't go that way.

>w
You can't go that way.

>go inside
conservatory
greenhouse with plants and a broken telescope. Something about the telescope might help you. You can go E or back outside.

You can see a telescope (in which are a screw key, a finderscope and a base) here.

>x telescope
a telescope that has been smashed, but some parts are still intact, may be used for something else.

In the telescope are a screw key, a finderscope and a base.

[Your score has just gone up by one point.]

>take telescope
Taken.

>i
You are carrying:
  a telescope
    a screw key
    a finderscope
    a base
  a flare gun
  a fire extinguisher

>x key
you combined the Scope Base with the screw to get screw key.

[Your score has just gone up by one point.]

>x scope
You can't see any such thing.

>x finderscope
You see nothing special about the finderscope.

>x base
You see nothing special about the base.

>combine finderscope with base
You fuse together the finderscope and the base.

You now have a scope base.

>combine scope base with screw
You fuse together scope base and the screw key.

You now have a a screw key.

>x screw key
you combined the Scope Base with the screw to get screw key.

>l
conservatory
greenhouse with plants and a broken telescope. Something about the telescope might help you. You can go E or back outside.

>e
living room
a place where the family came to eat. There is a dining table, a vase with flowers, and a butler named bob You can go E,W,N,S.

>talk to bob
Hello Officer, I may be able to assist you. Before Mr. Rich got murdered, he gave me a box and said to never let this out of sight, but I could never find the key for it. So, if you can find the key, we can open it and see what is inside. The only clue he gave me was that the key is somewhere up high.

>take the box
You can't see any such thing.

>take box
You can't see any such thing.

>x table
a long table that has nice furnishings. Not many things on this table.

>x vase
a circular object that holds flowers. There are many colorful flowers in this vase.

[Your score has just gone up by one point.]

>take flowers
You can't see any such thing.

>x flowers
You can't see any such thing.

>x bob
Bob is the butler of Mr. Rich's mansion. He is here everyday and helps out in any way that he can.

>e
kitchen
a place for cooking with a knife, and a TV.

You can see a gold door, a knife and a tv here.

>take knife
Taken.

>x knife
a sharp miracle blade.

>x tv
a large tv meant to watch cooking shows for ideas.

The tv is currently switched off.

>turn tv on
there is no time for watching cooking shows. Get back to solving the murder.

>take tv
Taken.

>i
You are carrying:
  a tv
  a knife
  a screw key
  a telescope
  a flare gun
  a fire extinguisher

>x gold door
You see nothing special about the gold door.

>open gold door
It seems to be locked.

>unlock gold door
What do you want to unlock the gold door with?

>screw key
Nothing obvious happens.

>open gold door
It seems to be locked.

>l
kitchen
a place for cooking with a knife, and a TV.

You can see a gold door here.

>w
living room
a place where the family came to eat. There is a dining table, a vase with flowers, and a butler named bob You can go E,W,N,S.

>n
Bathroom
a place to do your business. There is a toothbrush and a toilet. It looks like there might be a room above you as well.

You can see a toothbrush here.

>x toothbrush
a device to clean your teeth.

>take toothbrush
Taken.

>clean my teeth
You can't see any such thing.

>x toilet
a porcelain seat with water inside. It is clogged and unusable.

>go up
Darkness
It is pitch dark, and you can't see a thing.

>go d
Bathroom
a place to do your business. There is a toothbrush and a toilet. It looks like there might be a room above you as well.

>go e
You can't go that way.

* * *

>w
You can't go that way.

>s
living room
a place where the family came to eat. There is a dining table, a vase with flowers, and a butler named bob You can go E,W,N,S.

>s
Man cave
there is a bar, couches, pool table, 100" tv, and Wilfred, Mr. Rich's best friend. There is a room underneath you as well.

>x couches
very comfortable as if sitting on a cloud.

>x table
a fun game where you have to shoot the balls into the pockets.

>x tv
(the tv)
a large tv meant to watch cooking shows for ideas.

The tv is currently switched on.

>x 100" tv
You can't use multiple objects with that verb.

>x wilfred
Wilfred is Mr. Rich's best friend. He use to be homeless, but Mr. Rich decided to let him sleep and live in the Man cave. He is very sloppy, but respects Mr. Rich very much and does whatever he can to help around.

>talk to wilfred
Sup Officer, I didn't do anything. I've been in this Man Cave ever since I got here and I am also Mr. Rich's best friend. There is no way I would have committed a murder. Please tell me who killed my best friend when you find out. Thank you.

>go d
Garage
There is a car, a workbench, and many tools.

You can see a car, a workbench and a tools here.

>x car
a silky smooth black bentley, but it seems to be locked.

>unlock car with screw key
That doesn't seem to be something you can unlock.

>x workbench
There are many different tools on this workbench.

>x tools
screwdrivers, hammers, and nails, everything you need to fix a problem.

>take tools
Taken.

>take workbench
Taken.

>go u
Man cave
there is a bar, couches, pool table, 100" tv, and Wilfred, Mr. Rich's best friend. There is a room underneath you as well.

>gon
That's not a verb I recognise.

>n
living room
a place where the family came to eat. There is a dining table, a vase with flowers, and a butler named bob You can go E,W,N,S.

I beg your pardon?

>e
kitchen
a place for cooking with a knife, and a TV.

You can see a gold door here.

>w
living room
a place where the family came to eat. There is a dining table, a vase with flowers, and a butler named bob You can go E,W,N,S.

>w
conservatory
greenhouse with plants and a broken telescope. Something about the telescope might help you. You can go E or back outside.

>e
living room
a place where the family came to eat. There is a dining table, a vase with flowers, and a butler named bob You can go E,W,N,S.

>s
Man cave
there is a bar, couches, pool table, 100" tv, and Wilfred, Mr. Rich's best friend. There is a room underneath you as well.

>n
living room
a place where the family came to eat. There is a dining table, a vase with flowers, and a butler named bob You can go E,W,N,S.

>n
Bathroom
a place to do your business. There is a toothbrush and a toilet. It looks like there might be a room above you as well.

>fix toilet
That's not a verb I recognise.

>u
Darkness
It is pitch dark, and you can't see a thing.

>i
You are carrying:
  a workbench
  a tools
  a toothbrush
  a tv
  a knife
  a screw key
  a telescope
  a flare gun
  a fire extinguisher

>n
You can't go that way.

>d
Bathroom
a place to do your business. There is a toothbrush and a toilet. It looks like there might be a room above you as well.

>d
You can't go that way.

>e
You can't go that way.

>w
You can't go that way.

>n=s
That's not a verb I recognise.

>s
living room
a place where the family came to eat. There is a dining table, a vase with flowers, and a butler named bob You can go E,W,N,S.

>e
kitchen
a place for cooking with a knife, and a TV.

You can see a gold door here.

>x door
You see nothing special about the gold door.

>break door
Violence isn't the answer to this one.

>i
You are carrying:
  a workbench
  a tools
  a toothbrush
  a tv
  a knife
  a screw key
  a telescope
  a flare gun
  a fire extinguisher

>x key
you combined the Scope Base with the screw to get screw key.

>e
(first opening the gold door)
It seems to be locked.

>go w
living room
a place where the family came to eat. There is a dining table, a vase with flowers, and a butler named bob You can go E,W,N,S.

>go e
kitchen
a place for cooking with a knife, and a TV.

You can see a gold door here.

>go w
living room
a place where the family came to eat. There is a dining table, a vase with flowers, and a butler named bob You can go E,W,N,S.

>go w
conservatory
greenhouse with plants and a broken telescope. Something about the telescope might help you. You can go E or back outside.

>go e
living room
a place where the family came to eat. There is a dining table, a vase with flowers, and a butler named bob You can go E,W,N,S.

* * *

>take flashlight
Taken.

    *** You have won ***

In that game you scored 0 out of a possible 10, in 1 turn.

Would you like to RESTART, RESTORE a saved game, QUIT or UNDO the last command?

>inside
conservatory
greenhouse with plants and a broken telescope. Something about the telescope might help you.

You can see a telescope (in which are a screw key, a finderscope and a base) here.

* * *

>e
living room
a place where the family came to eat. There is a dining table, a vase, and a butler named bob.

You can see a pool door here.

>e
(first opening the pool door)
It seems to be locked.

>e
(first opening the pool door)
It seems to be locked.

>open door
It seems to be locked.

>talk to bob
Hello Officer, I may be able to assist you. Before Mr. Rich got murdered, he gave me a hint to opening his safe because he had a feeling that his death was imminent. He said that there are many objects and you may have to combine things to open it. I just didn't know what items combined with each other. If you can figure it out, you can open it.

>s
Man cave
there is a bar, couches, pool table, 100" tv, and Wilfred, Mr. Rich's best friend and a pool stick. There is a room underneath you as well.

You can see a bar, a couches, a pool table, a pool stick and a 100' tv here.

* * *

>n
living room
a place where the family came to eat. There is a dining table, a vase, and a butler named bob.

You can see a pool door here.

>x door
a special door that seems to be locked. There may be a special pool stick that will open it.

>n
Bathroom
a place to do your business. There is a toothbrush and a toilet. It looks like there might be a room above you as well.

You can see a toothbrush here.

* * *

>up
Darkness
It is pitch dark, and you can't see a thing.

>use flashlight
[Your score has just gone up by one point.]

>turn on flashlight
Yay! you can finally see something in this dark dark room.

Attic
 A room full of memories such as paintings and books. This was Mr. Rich's secret room that not many people knew about because it was above the bathroom.

You can see a paintings and a books here.

* * *

>take paintings
a gold key appears from underneath the paintings.

>x paintings
Artwork from Mr. Rich's childhood days. Taking the paintings for the family will be very appreciated.

>take key
(the gold key)
Taken.

* * *

>s
living room
a place where the family came to eat. There is a dining table, a vase, and a butler named bob.

You can see a pool door here.

>e
(first opening the pool door)
It seems to be locked.

>unlock door
What do you want to unlock the pool door with?

>pool stick
You unlock the pool door.

>e
(first opening the pool door)
Bedroom
a place for sleeping. There is a bed, a clock, and a safe.

You can see a gold door, a door, a bed, a clock and a safe (closed) here.

you are in the bedroom.

kitchen
a place for cooking with a knife, and a TV.

You can see a pool door, a gold door, a knife and a tv here.

>x knife
a sharp miracle blade.

* * *

>x tv
a large tv meant to watch cooking shows for ideas.

The tv is currently switched off.

>take tv
That's fixed in place.

>turn on tv
there is no time for watching cooking shows. Get back to solving the murder.

>e
(first opening the gold door)
It seems to be locked.

>unlock door
Which do you mean, the pool door or the gold door?

>gold door
What do you want to unlock the gold door with?

>gold key
You unlock the gold door.

* * *

>e
(first opening the gold door)
Bedroom
a place for sleeping. There is a bed, a clock, and a safe.

You can see a gold door, a door, a bed, a clock and a safe (closed) here.

you are in the bedroom.

Bedroom
a place for sleeping. There is a bed, a clock, and a safe.

You can see a gold door, a door, a bed, a clock and a safe (closed) here.

>x bed
A place for sleeping.

>enter bed
no time for sleeping, get back on the case!

>go in bed
But you're already on the bed.

>x safe
a big safe for certain items.

>open safe
It seems to be locked.

>unlock safe
What do you want to unlock the safe with?

* * *

>open safe
there is a piece of broken glass in here.

>x glass
couple pieces of glass with blood stains.

after taking a closer look, you notice that this was the weapon the killer used based on Mr. Rich's wounds.

>take glass
[Your score has just gone up by one point.]

I beg your pardon?

>take glass
You already have that.

>x chief
You can't see any such thing.

>give glass to chief
You can't see any such thing.

>give the broken glass to the chief
You can't see any such thing.

>undo
Bedroom
[Previous turn undone.]

>give glass
(to yourself)
You juggle the broken glass for a while, but don't achieve much.

>take glass
You already have that.

>give glass to chief
You can't see any such thing.

>open safe
That's already open.

>give broken glass to chief
You can't see any such thing.

* * *

>n
living room
a place where the family came to eat. There is a dining table, a vase, and a butler named bob.

You can see a pool door here.

>n
Bathroom
a place to do your business. There is a toothbrush and a toilet. It looks like there might be a room above you as well.

You can see a toothbrush here.

* * *

>down
Bathroom
a place to do your business. There is a toothbrush and a toilet. It looks like there might be a room above you as well.

You can see a toothbrush here.

>e
You can't go that way.

>s
living room
a place where the family came to eat. There is a dining table, a vase, and a butler named bob.

You can see a pool door here.

* * *

>e
(first opening the pool door)
It seems to be locked.

>unlock pool door with pool stick
You unlock the pool door.

>open door
Bedroom
a place for sleeping. There is a bed, a clock, and a safe.

You can see a gold door, a door, a bed, a clock and a safe (closed) here.

you are in the bedroom.

>open gold door
It seems to be locked.

>e
You can't go that way.

>e
You can't go that way.

>unlock gold door
What do you want to unlock the gold door with?

* * *

>gold key
You unlock the gold door.

>open door
Which do you mean, the gold door or the door?

>gold door
Bedroom
a place for sleeping. There is a bed, a clock, and a safe.

You can see a gold door, a door, a bed, a clock and a safe (closed) here.

you are in the bedroom.

I beg your pardon?

>unlock safe with screw key
You unlock the safe.

>open safe
[Your score has just gone up by one point.]

I beg your pardon?

>open safe
That's already open.

>x glass
couple pieces of glass with blood stains.

after taking a closer look, you notice that this was the weapon the killer used based on Mr. Rich's wounds.

* * *

>give the glass to the chief
The chief doesn't seem interested.

>undo
Bedroom
[Previous turn undone.]

>undo
Bedroom
[Previous turn undone.]

>open safe
That's already open.

>unlock safe
What do you want to unlock the safe with?

* * *

>screw key
Which do you mean, the gold key or the screw key?

>screw key
Which do you mean, the gold key or the screw key?

>x glass
couple pieces of glass with blood stains.

after taking a closer look, you notice that this was the weapon the killer used based on Mr. Rich's wounds.

* * *

>n
living room
a place where the family came to eat. There is a dining table, a vase, and a butler named bob.

You can see a pool door here.

>open door
It seems to be locked.

>unlock door
What do you want to unlock the pool door with?

* * *

>pool stick
You unlock the pool door.

>open door
Bedroom
a place for sleeping. There is a bed, a clock, and a safe.

You can see a gold door, a door, a bed, a clock and a safe (closed) here.

you are in the bedroom.

>n
You can't go that way.

>w
(first opening the gold door)
It seems to be locked.

>n
You can't go that way.

* * *

>w
(first opening the gold door)
It seems to be locked.

>e
You can't go that way.

>w
(first opening the gold door)
It seems to be locked.

>w
(first opening the gold door)
It seems to be locked.

>undo
Bedroom
[Previous turn undone.]

* * *

>s
living room
a place where the family came to eat. There is a dining table, a vase, and a butler named bob.

You can see a pool door here.

>s
Man cave
there is a bar, couches, pool table, 100" tv, and Wilfred, Mr. Rich's best friend and a pool stick. There is a room underneath you as well.

You can see a bar, a couches, a pool table, a pool stick and a 100' tv here.

* * *

>n
living room
a place where the family came to eat. There is a dining table, a vase, and a butler named bob.

You can see a pool door here.

>unlock pool door with
What do you want to unlock the pool door with?

>pool stick
You unlock the pool door.

>open pool door
[Your score has just gone up by one point.]

* * *

>n
living room
a place where the family came to eat. There is a dining table, a vase, and a butler named bob.

You can see a pool door here.

>e
(first opening the pool door)
It seems to be locked.

* * *

>unlock pool door with pool stick
You unlock the pool door.

>open door
kitchen
a place for cooking with a knife, and a TV.

You can see a pool door, a gold door, a knife and a tv here.

you are in the kitchen.

>e
(first opening the gold door)
It seems to be locked.

* * *

>gold key
You unlock the gold door.

>open door
Which do you mean, the pool door or the gold door?

>open gold door
Bedroom
a place for sleeping. There is a bed, a clock, and a safe.

You can see a gold door, a door, a bed, a clock and a safe (closed) here.

you are in the bedroom.

>x safe
a big safe for certain items.

>unlock safe
What do you want to unlock the safe with?

* * *

>open safe
there is a piece of broken glass in here.

>undo
Bedroom
[Previous turn undone.]

>open safe
there is a piece of broken glass in here.

>take broken glass
    *** You have won ***

In that game you scored 1 out of a possible 10, in 24 turns.

Would you like to RESTART, RESTORE a saved game, QUIT or UNDO the last command?

>undo
Bedroom
[Previous turn undone.]

* * *

>e
living room
a place where the family came to eat. There is a dining table, a vase, and a butler named bob.

>n
Bathroom
a place to do your business. There is a toothbrush and a toilet. It looks like there might be a room above you as well.

You can see a toothbrush here.

* * *

>use flashlight
[Your score has just gone up by one point.]

>turn on flashlight
Yay! you can finally see something in this dark dark room.

Attic
Many paintings and books.

You can see a paintings and a books here.

* * *

>n
Bathroom
a place to do your business. There is a toothbrush and a toilet. It looks like there might be a room above you as well.

You can see a toothbrush here.

>use toothbrush
You can't see any such thing.

>up
Darkness
It is pitch dark, and you can't see a thing.

* * *

>take flashlight
Taken.

    *** You have won ***

In that game you scored 0 out of a possible 10, in 1 turn.

Would you like to RESTART, RESTORE a saved game, QUIT or UNDO the last command?

>use flashlight
[Your score has just gone up by one point.]

>inside
conservatory
greenhouse with plants and a broken telescope. Something about the telescope might help you. You can go E or back outside.

You can see a telescope (in which are a screw key, a finderscope and a base) here.

>e
living room
a place where the family came to eat. There is a dining table, a vase with flowers, and a butler named bob You can go E,W,N,S.

>n
Bathroom
a place to do your business. There is a toothbrush and a toilet. It looks like there might be a room above you as well.

You can see a toothbrush here.

* * *

>turn on flashlight
Yay! you can finally see something in this dark dark room.

Attic
Many paintings and books.

You can see a paintings and a books here.

>down
Bathroom
a place to do your business. There is a toothbrush and a toilet. It looks like there might be a room above you as well.

You can see a toothbrush here.

>w
You can't go that way.

* * *

>s
living room
a place where the family came to eat. There is a dining table, a vase with flowers, and a butler named bob You can go E,W,N,S.

>x vase
a circular object that holds flowers. There are many colorful flowers in this vase.

[Your score has just gone up by one point.]

>x vase
a circular object that holds flowers. There are many colorful flowers in this vase.